
Starting position: Point(x=18, y=4)
Exit: Point(x=1, y=16)
Maze:
[[1 1 1 0 1 0 0 1 0 1 0 0 0 1 1 0 0 0 0 0]
 [0 0 0 0 0 1 0 0 0 1 1 0 0 1 0 0 1 1 0 1]
 [0 1 0 1 1 0 0 0 0 0 0 1 0 0 1 0 1 0 0 0]
 [1 0 0 0 0 1 1 1 0 1 1 1 0 0 0 0 0 1 0 0]
 [1 1 0 0 1 0 0 0 0 0 1 0 1 1 0 0 0 1 0 1]
 [1 1 0 0 1 1 1 1 1 0 0 0 0 0 1 0 1 0 0 1]
 [0 0 0 0 0 0 0 0 0 0 0 0 1 0 0 0 1 0 0 1]
 [0 0 1 1 1 0 1 0 0 0 1 0 0 0 0 0 0 0 1 0]
 [1 0 0 0 0 0 1 0 1 0 1 1 0 0 1 0 1 0 0 0]
 [0 1 1 0 1 1 1 0 0 1 1 1 1 0 1 1 1 1 0 0]
 [1 0 0 1 0 1 0 0 0 0 0 0 0 0 0 0 0 0 0 0]
 [0 0 0 1 0 1 1 0 0 0 1 0 1 0 1 1 1 1 0 0]
 [1 1 0 0 0 0 0 0 0 0 0 0 0 0 0 1 1 0 0 1]
 [1 0 0 0 0 0 0 1 1 1 1 0 1 0 0 0 0 0 1 0]
 [0 0 0 1 0 0 0 1 0 0 0 0 0 1 0 1 0 0 0 0]
 [1 0 0 1 1 0 1 1 1 0 1 1 0 1 0 0 0 0 0 0]
 [0 2 0 1 1 1 1 0 0 0 1 0 0 0 0 0 1 0 1 1]
 [0 0 0 0 0 0 0 0 1 0 0 0 0 0 1 1 0 0 0 0]
 [0 0 0 0 0 0 0 1 1 0 1 0 1 0 0 0 0 1 0 0]
 [0 0 0 0 0 0 0 0 1 0 0 0 0 1 1 0 0 0 0 1]]