Starting position: Point(x=15, y=2)
Exit: Point(x=1, y=18)
Maze:
[[1 0 1 0 1 0 0 0 1 1 0 1 0 0 0 0 0 0 1 0]
 [1 0 0 1 1 0 1 0 0 1 0 0 0 1 1 0 1 0 1 1]
 [1 0 0 0 0 0 1 0 0 0 0 0 0 0 0 0 0 0 0 1]
 [1 0 1 0 0 1 0 1 0 1 1 1 1 0 0 0 1 1 1 0]
 [0 0 1 0 0 0 1 0 0 0 0 0 0 0 1 0 0 0 1 0]
 [0 0 1 0 1 0 1 0 1 1 1 1 0 1 1 0 1 1 0 0]
 [1 0 0 1 0 0 1 0 0 0 0 0 1 0 0 0 0 0 0 0]
 [1 0 1 1 1 0 0 0 0 0 1 0 1 0 1 1 1 1 1 0]
 [1 0 1 0 1 0 0 0 0 1 0 0 0 0 0 0 0 0 0 0]
 [0 0 1 0 0 0 0 0 0 0 0 1 1 0 0 1 1 0 0 0]
 [1 0 0 0 1 1 0 0 0 1 0 1 0 0 0 0 0 0 0 0]
 [0 0 1 0 1 0 0 0 1 1 0 0 0 1 0 1 1 1 1 1]
 [1 0 0 0 1 0 0 0 0 0 0 1 0 1 1 1 0 0 1 0]
 [0 0 1 1 1 0 0 1 1 1 1 0 1 1 1 0 0 0 0 0]
 [0 0 1 1 0 0 1 0 1 0 1 0 0 0 0 0 0 0 1 0]
 [0 1 1 0 1 0 0 0 0 0 0 0 0 0 0 0 0 0 0 1]
 [0 0 0 0 0 0 1 0 1 0 1 0 0 1 0 1 0 0 0 1]
 [1 1 1 0 1 0 1 0 0 0 1 0 0 1 0 0 0 1 0 1]
 [1 2 0 0 1 0 1 0 1 1 0 0 0 0 0 1 0 1 0 1]
 [1 1 0 0 0 0 0 1 1 1 0 0 1 1 1 0 1 0 1 1]]
Policy 0:
α=0.1, γ=0.99, ϵ=0.01
[[0. 0. 0. 0.]
 [0. 0. 0. 0.]
 [0. 0. 0. 0.]
 ...
 [0. 0. 0. 0.]
 [0. 0. 0. 0.]
 [0. 0. 0. 0.]]

