Starting position: Point(x=4, y=4)
Exit: Point(x=18, y=17)
Maze:
[[0 1 1 1 1 0 1 0 0 1 1 0 1 0 0 0 1 0 1 1]
 [1 0 0 0 0 0 0 1 0 0 0 0 0 1 0 0 0 0 0 0]
 [1 1 1 0 0 0 0 1 0 0 0 1 0 1 0 1 0 1 1 0]
 [0 0 0 0 1 1 1 0 0 0 0 0 0 0 0 0 0 0 0 1]
 [1 1 0 0 0 0 1 1 0 1 0 1 0 0 0 1 0 0 0 1]
 [1 0 0 0 1 1 1 1 0 0 0 1 0 0 0 0 0 1 1 0]
 [1 1 0 0 0 0 0 1 0 1 0 1 1 1 0 0 0 1 0 0]
 [1 0 0 0 0 0 0 1 0 0 0 0 1 1 0 1 1 1 0 0]
 [0 1 1 1 1 1 0 0 0 0 0 1 0 0 0 0 1 1 0 1]
 [0 0 1 1 0 1 0 1 0 1 0 0 1 0 1 0 1 1 0 1]
 [1 0 0 0 0 1 0 0 0 1 0 0 1 0 0 0 1 1 0 0]
 [0 0 0 0 0 0 0 1 1 1 1 0 1 0 1 1 1 0 0 0]
 [1 0 0 0 0 1 0 0 0 0 0 0 0 0 1 0 1 0 1 1]
 [0 0 1 1 0 1 0 0 1 0 1 0 1 0 1 0 1 0 0 0]
 [1 1 1 1 0 0 0 0 1 0 1 0 0 0 1 0 0 0 0 1]
 [0 0 0 1 0 1 1 0 0 0 1 0 1 0 0 0 1 0 0 0]
 [0 0 0 0 1 1 1 0 0 0 0 0 0 0 1 1 0 0 0 0]
 [1 1 0 1 1 0 0 0 0 0 0 1 1 0 0 0 1 0 2 0]
 [0 0 0 0 0 0 1 0 1 0 0 1 0 0 0 0 1 1 0 0]
 [0 1 0 1 0 1 0 0 1 0 0 1 0 1 1 0 0 0 0 1]]
Policy 0:
α=0.1, γ=0.99, ϵ=0.01
[[   0.            0.            0.            0.        ]
 [   0.            0.            0.            0.        ]
 [   0.            0.            0.            0.        ]
 ...
 [ -74.43617655  -38.13122342  -57.99699534  -78.94313586]
 [-107.46113525 -112.63456584  -90.45496955 -101.05518151]
 [   0.            0.            0.            0.        ]]

