
Starting position: Point(x=4, y=15)
Exit: Point(x=18, y=4)
Maze:
[[0 0 0 0 0 1 1 0 0 0 1 1 0 1 0 0 0 1 0 0]
 [0 0 0 0 1 1 0 0 1 1 0 1 0 0 0 0 0 0 0 0]
 [0 1 0 0 0 0 0 0 1 0 0 0 0 1 0 0 1 1 1 1]
 [1 0 0 0 0 1 0 0 0 0 0 1 1 0 0 1 0 1 0 0]
 [1 0 1 0 0 0 0 0 1 0 0 0 0 0 1 1 0 1 2 1]
 [1 0 0 0 0 0 1 1 0 0 0 0 1 0 0 0 0 0 0 0]
 [0 1 1 1 1 0 1 0 0 0 0 0 1 1 1 0 0 0 0 0]
 [0 0 1 1 1 0 1 1 1 0 1 1 1 1 1 1 1 1 1 0]
 [1 0 0 0 0 0 1 0 1 0 0 0 0 0 0 0 0 0 0 0]
 [1 0 0 1 0 0 0 0 0 0 1 0 1 0 0 0 0 0 1 1]
 [1 1 1 0 1 0 0 1 1 0 0 0 0 0 0 0 0 0 0 1]
 [0 0 1 0 1 0 0 0 1 0 1 0 0 1 0 0 1 1 0 0]
 [0 0 0 0 0 0 0 1 1 0 0 1 1 1 0 0 0 1 1 0]
 [0 1 0 1 1 0 0 0 1 0 0 0 0 0 1 0 0 0 0 1]
 [0 1 1 1 1 0 0 0 1 0 0 1 0 0 0 0 1 1 1 0]
 [1 0 1 0 0 0 1 0 0 1 0 0 1 0 1 0 0 0 0 1]
 [1 0 0 0 1 0 0 0 1 0 1 0 0 0 1 1 0 1 0 0]
 [0 0 1 0 0 0 0 0 1 0 0 0 0 0 0 1 0 1 0 1]
 [0 0 0 0 1 0 1 0 1 0 0 1 0 1 0 1 0 1 0 0]
 [0 1 1 1 0 0 0 1 1 0 0 1 1 0 1 0 1 1 1 1]]