
Starting position: Point(x=2, y=4)
Exit: Point(x=14, y=16)
Maze:
[[0 0 1 0 0 0 0 1 1 0 1 0 0 0 0 1 1 0 0 1]
 [0 0 0 0 1 0 0 0 1 1 0 1 0 0 0 0 0 0 0 0]
 [0 1 1 0 0 0 0 0 0 1 0 0 0 1 1 1 0 1 1 1]
 [0 1 0 0 1 1 0 1 0 0 0 1 1 1 0 1 1 0 1 0]
 [1 0 0 0 0 1 1 0 0 1 0 0 0 0 0 1 1 0 0 0]
 [0 1 0 0 0 0 0 1 0 1 0 0 0 1 0 0 0 0 1 0]
 [0 1 0 1 1 0 0 1 0 1 1 0 1 0 0 1 0 1 1 1]
 [1 0 0 0 1 0 1 1 0 0 0 0 0 1 0 1 1 0 1 0]
 [0 0 1 1 1 1 1 1 0 0 1 0 1 1 0 0 0 0 0 1]
 [0 0 0 0 0 0 0 1 1 0 1 1 1 0 0 1 1 0 1 1]
 [0 1 0 1 1 1 0 0 0 0 0 0 1 1 0 0 1 0 1 1]
 [1 0 0 0 1 1 1 1 1 0 1 0 1 0 0 0 1 0 0 0]
 [1 1 1 0 0 0 0 0 0 0 0 0 0 1 0 0 1 1 0 1]
 [1 1 0 0 1 0 1 0 0 1 1 0 0 1 1 1 1 0 0 1]
 [1 0 0 0 1 1 1 0 0 0 0 0 1 0 0 0 1 1 0 1]
 [0 1 0 0 0 1 0 0 1 0 1 1 1 0 0 0 0 0 0 1]
 [0 0 0 1 0 1 0 0 1 0 0 0 0 0 2 1 1 0 0 1]
 [1 0 0 1 1 1 0 1 1 1 1 1 0 1 0 1 0 0 1 0]
 [0 0 0 0 0 0 0 0 0 0 0 1 0 0 0 1 0 0 0 1]
 [1 0 0 1 1 1 0 0 0 1 0 0 0 0 0 0 0 1 0 0]]