
Starting position: Point(x=4, y=16)
Exit: Point(x=14, y=1)
Maze:
[[1 0 1 0 1 1 0 1 0 0 1 1 1 0 1 1 0 1 1 0]
 [0 0 1 1 0 1 0 0 1 0 0 1 1 0 2 1 0 0 0 1]
 [0 0 0 1 0 0 0 0 0 0 1 1 0 0 1 0 0 0 0 0]
 [0 1 0 0 0 1 1 1 0 0 0 1 1 0 1 0 0 0 1 1]
 [1 1 1 1 0 0 0 1 1 1 0 0 1 0 1 0 1 0 0 0]
 [0 0 0 0 0 0 1 1 0 1 0 0 1 0 0 0 0 0 0 0]
 [1 1 1 0 0 0 0 0 0 1 0 0 0 0 0 0 0 0 1 1]
 [1 1 1 0 0 0 1 1 0 0 0 1 1 0 0 0 1 0 1 1]
 [0 0 1 0 0 1 0 0 0 0 0 0 0 0 0 0 1 0 0 0]
 [0 0 1 1 0 0 0 0 1 0 0 1 1 1 1 1 1 0 0 0]
 [0 0 1 0 0 1 0 0 1 0 1 1 0 1 0 1 0 0 0 0]
 [1 0 0 0 1 0 1 0 0 0 0 0 0 0 0 0 0 1 0 1]
 [0 0 1 0 0 0 0 1 0 0 1 1 1 0 1 0 0 0 0 0]
 [0 1 1 0 1 1 0 0 0 0 0 1 0 1 1 0 1 0 0 1]
 [1 0 0 0 0 1 0 0 0 0 0 0 0 0 0 0 0 0 0 0]
 [0 0 1 1 0 0 0 1 1 0 1 1 1 0 1 0 0 0 1 0]
 [0 0 0 0 0 1 1 0 0 0 0 1 1 0 0 0 0 0 0 0]
 [1 1 1 0 1 1 1 0 0 1 0 0 0 0 1 0 1 0 0 0]
 [0 0 0 0 0 0 0 0 1 0 0 0 1 0 1 0 0 1 0 0]
 [1 1 0 0 0 0 1 0 0 0 1 0 1 1 0 0 1 0 0 0]]