
Starting position: Point(x=3, y=3)
Exit: Point(x=18, y=18)
Maze:
[[0 1 1 0 1 0 1 0 0 1 0 0 1 1 1 1 0 0 0 0]
 [0 0 0 0 0 0 0 0 1 1 0 0 0 1 0 0 0 0 0 1]
 [0 1 0 1 0 0 1 0 0 1 1 0 1 1 0 1 1 0 0 0]
 [0 0 0 0 0 0 0 0 0 0 0 0 0 0 0 1 0 0 1 0]
 [1 1 0 1 0 0 1 1 1 0 0 0 1 1 0 1 0 0 1 1]
 [1 0 0 0 0 0 0 0 1 0 0 0 0 0 0 0 0 1 0 0]
 [0 0 1 0 0 1 0 0 1 0 0 0 1 1 0 1 0 0 0 0]
 [1 1 1 0 1 1 0 0 0 0 1 0 0 0 0 0 0 0 0 1]
 [0 0 0 1 0 0 0 1 0 0 0 0 1 1 0 1 0 0 0 0]
 [0 0 0 0 0 0 0 0 1 1 1 1 1 0 0 0 0 0 1 0]
 [1 0 0 0 0 1 1 0 1 1 0 1 1 1 0 1 0 0 0 0]
 [1 0 0 1 1 1 1 1 1 0 1 0 0 0 0 1 1 0 0 1]
 [0 0 1 0 0 1 0 1 0 0 0 0 0 0 1 0 1 0 0 0]
 [0 0 0 0 0 0 0 0 0 1 0 1 1 0 1 0 0 0 0 0]
 [0 1 1 1 1 1 0 0 1 1 0 1 1 0 0 1 1 1 1 1]
 [1 0 0 0 0 0 0 0 0 0 0 0 0 0 0 0 0 1 0 0]
 [0 1 0 1 1 0 1 0 1 1 0 1 0 0 0 1 0 0 0 0]
 [1 1 1 1 0 0 1 1 1 0 1 1 0 1 0 0 0 0 1 1]
 [0 0 0 0 0 0 0 0 0 0 1 0 0 0 0 0 0 0 2 0]
 [0 0 0 0 0 1 1 0 0 1 1 0 0 1 1 0 1 0 1 1]]
Policy 0:
α=0.1, γ=0.99, ϵ=0.01
