
Starting position: Point(x=4, y=17)
Exit: Point(x=17, y=1)
Maze:
[[0 0 0 0 0 0 1 1 1 0 1 0 0 0 0 1 0 1 0 1]
 [1 0 0 1 0 1 0 0 0 0 0 0 0 0 1 0 0 2 0 1]
 [0 1 0 1 0 1 1 0 0 0 0 1 0 0 0 0 1 1 1 1]
 [1 0 0 0 0 0 0 0 1 1 0 0 0 1 0 0 1 0 0 0]
 [1 1 0 1 0 0 0 0 1 0 0 1 0 0 0 1 1 0 0 0]
 [1 0 0 1 1 0 1 0 0 0 0 1 1 1 0 0 1 0 1 1]
 [1 1 0 1 0 0 1 0 1 0 0 0 1 0 0 0 1 0 0 1]
 [1 0 0 0 1 0 0 0 0 0 0 0 1 0 0 0 0 0 1 0]
 [0 1 0 0 0 0 0 1 0 0 0 0 1 1 0 1 1 1 1 0]
 [1 1 1 0 0 1 0 0 0 0 0 0 0 0 0 0 1 0 0 0]
 [0 0 0 1 1 0 1 1 1 0 1 1 0 1 1 1 1 0 1 0]
 [1 0 0 1 0 0 1 1 1 0 0 1 0 0 0 0 0 0 0 1]
 [0 0 0 0 0 0 0 0 0 0 1 1 0 1 1 0 1 1 1 1]
 [0 1 1 0 1 0 1 0 0 0 0 1 0 1 0 0 0 0 0 1]
 [0 0 1 0 0 0 0 0 1 0 0 0 0 1 0 1 0 1 0 1]
 [1 0 1 0 0 1 1 1 1 1 0 0 0 0 0 0 0 1 1 0]
 [0 0 0 0 0 0 0 1 0 0 0 1 1 1 0 1 1 0 1 0]
 [0 1 0 1 0 0 0 0 0 0 0 0 0 0 0 0 0 0 0 0]
 [1 0 0 1 1 0 1 0 0 1 0 1 0 1 0 1 0 1 0 0]
 [0 0 0 1 0 1 0 0 1 1 0 1 0 1 1 1 0 0 0 0]]