
Starting position: Point(x=1, y=15)
Exit: Point(x=15, y=3)
Maze:
[[1 1 1 0 1 0 1 0 0 0 0 0 0 1 1 0 0 1 0 1]
 [0 0 1 0 0 1 0 1 1 0 0 1 0 0 0 0 0 0 0 0]
 [1 0 1 0 0 0 0 1 1 1 0 1 0 1 1 1 1 1 0 0]
 [0 0 0 0 1 1 0 1 0 0 0 0 0 0 0 2 0 0 0 1]
 [1 0 1 0 1 1 0 1 0 1 0 1 1 0 1 1 0 0 1 0]
 [0 0 1 0 0 0 0 0 0 0 0 0 0 0 0 1 1 1 0 0]
 [0 0 1 0 1 1 1 0 0 1 1 0 1 0 0 0 0 0 0 0]
 [1 0 0 0 0 1 1 0 0 1 1 0 1 1 0 1 1 0 0 0]
 [0 0 0 1 1 1 0 0 1 1 0 0 0 0 0 0 0 0 0 0]
 [1 0 1 0 0 0 0 0 0 0 0 0 0 0 1 1 0 1 0 1]
 [0 0 0 0 0 0 1 0 1 0 0 1 1 0 1 0 1 0 0 1]
 [1 0 1 1 1 1 1 0 0 1 0 1 1 0 1 0 0 0 0 0]
 [0 0 0 0 0 0 0 0 0 1 0 0 0 0 1 0 1 1 0 1]
 [1 0 0 1 0 1 0 1 1 1 0 0 1 0 1 0 1 0 0 0]
 [1 0 0 1 0 1 1 0 1 0 0 0 0 0 0 0 0 0 0 0]
 [0 0 0 0 0 0 0 0 0 0 0 1 0 1 1 1 0 0 0 0]
 [1 1 0 1 0 0 0 0 1 0 0 1 0 0 0 1 1 0 0 1]
 [1 0 0 0 0 0 0 0 1 0 0 1 0 0 1 0 0 1 0 0]
 [1 1 0 0 0 0 1 0 0 0 0 0 0 0 0 0 0 1 0 1]
 [0 1 1 0 1 1 1 1 1 1 0 1 1 1 0 0 0 1 0 0]]