
Starting position: Point(x=18, y=18)
Exit: Point(x=4, y=2)
Maze:
[[0 0 0 1 0 1 0 0 1 0 0 1 0 1 1 1 0 0 1 0]
 [0 0 0 1 0 0 1 1 0 1 1 0 1 0 1 0 1 0 1 0]
 [0 0 0 1 2 0 1 0 0 1 0 0 0 0 0 0 0 0 0 0]
 [0 0 1 0 0 0 0 0 0 0 0 1 0 1 1 1 0 0 1 1]
 [1 0 1 1 0 1 1 0 0 0 1 0 0 0 0 1 1 1 1 1]
 [0 0 1 1 0 0 0 0 1 1 1 1 0 0 0 1 0 0 0 0]
 [1 0 0 0 0 0 1 1 1 1 0 1 1 1 0 1 0 0 0 1]
 [1 0 0 0 1 0 0 0 0 1 0 1 1 0 1 0 0 0 0 1]
 [1 0 1 1 0 0 1 1 0 0 0 0 1 0 0 0 0 0 0 0]
 [0 0 0 1 1 0 1 0 0 0 1 0 0 0 0 0 1 1 0 1]
 [0 0 1 1 0 0 1 0 1 1 1 1 0 0 0 0 0 0 0 0]
 [1 0 0 1 0 0 0 0 0 0 0 0 0 0 0 0 1 0 1 1]
 [1 0 1 1 0 0 0 0 0 1 1 0 0 0 1 1 0 0 1 0]
 [0 0 1 1 0 1 0 0 0 0 0 0 0 0 0 1 0 0 0 1]
 [1 0 0 0 0 1 0 1 0 1 1 0 1 0 1 1 0 1 0 0]
 [1 1 0 1 0 0 0 0 0 1 0 0 0 0 0 0 0 0 0 0]
 [0 0 0 0 0 0 0 0 0 0 0 0 1 0 1 1 0 1 1 1]
 [0 0 0 0 0 1 0 0 0 1 0 0 0 0 0 0 0 0 1 0]
 [0 0 1 0 1 0 0 0 0 0 0 0 0 0 0 1 0 0 0 0]
 [1 1 0 0 0 0 0 0 1 1 0 1 0 1 0 0 0 0 0 0]]