
Starting position: Point(x=2, y=14)
Exit: Point(x=17, y=2)
Maze:
[[0 0 0 1 0 0 0 1 0 0 1 0 1 0 0 1 1 0 0 0]
 [0 1 0 0 0 0 1 1 1 0 1 1 0 0 0 1 1 0 0 1]
 [0 0 0 1 1 0 0 1 0 0 0 1 1 0 1 1 0 2 1 0]
 [1 1 0 1 0 1 0 0 0 1 0 1 1 0 1 0 0 0 0 0]
 [1 1 0 0 0 1 0 1 0 1 0 0 0 0 1 0 0 0 1 1]
 [0 0 1 0 0 0 0 1 0 1 0 0 1 0 1 0 1 1 1 0]
 [0 0 1 1 1 1 0 1 0 0 0 0 1 0 1 0 0 0 0 1]
 [0 0 0 1 0 0 0 0 0 1 1 0 1 0 1 0 0 0 1 0]
 [1 1 0 1 1 1 1 1 0 1 0 0 0 0 0 0 0 0 0 0]
 [0 0 0 0 0 0 0 0 0 0 1 1 1 0 1 1 0 1 1 1]
 [0 0 1 1 1 0 0 0 1 0 0 1 0 0 0 0 0 1 0 0]
 [1 0 0 0 0 0 0 0 0 0 0 0 0 0 1 1 1 1 0 0]
 [1 1 0 0 0 0 1 0 1 0 0 0 0 0 0 0 0 0 0 0]
 [1 0 0 1 1 1 1 1 1 1 0 1 0 0 1 1 1 0 1 0]
 [0 1 0 1 0 1 0 1 0 0 0 0 0 0 1 1 0 0 0 0]
 [0 0 0 0 0 0 0 0 0 0 1 0 1 0 0 0 0 1 1 1]
 [0 1 1 0 1 0 1 0 0 0 0 0 0 0 1 1 0 0 0 0]
 [1 1 1 0 1 0 1 1 1 1 1 0 1 1 0 0 0 0 1 0]
 [1 0 0 0 0 0 1 0 0 0 0 0 1 0 0 0 0 0 0 1]
 [1 0 1 1 1 0 0 0 0 0 0 0 0 1 0 0 0 1 1 0]]