
Starting position: Point(x=17, y=18)
Exit: Point(x=1, y=1)
Maze:
[[0 0 1 1 0 0 0 0 0 1 0 1 1 0 0 0 0 0 0 1]
 [0 2 0 0 1 1 0 0 0 0 0 1 0 1 1 0 0 0 0 0]
 [1 1 0 0 0 1 0 0 0 0 0 0 0 1 0 0 1 1 0 1]
 [0 1 1 0 1 1 1 1 0 0 1 0 0 1 1 0 1 0 0 1]
 [0 0 0 0 1 1 1 1 0 1 1 1 0 1 0 0 0 0 0 1]
 [0 1 0 0 0 1 0 0 0 0 0 0 0 0 0 0 0 1 0 1]
 [0 1 1 0 0 1 0 1 0 1 0 1 0 0 0 0 1 1 1 0]
 [0 0 0 0 0 0 0 0 0 0 0 0 0 0 0 0 0 0 0 1]
 [0 1 0 0 1 1 1 1 0 0 1 0 1 0 1 1 1 1 0 0]
 [1 1 1 0 0 1 0 0 0 0 1 1 0 0 1 1 0 1 1 1]
 [0 0 0 0 0 0 0 1 0 0 0 0 0 0 0 0 0 0 0 1]
 [0 0 1 1 0 1 0 1 0 0 0 0 0 0 1 1 1 0 0 1]
 [0 0 0 1 0 1 0 1 0 0 0 1 0 0 0 0 0 0 1 0]
 [0 0 0 0 0 1 0 1 1 0 1 0 0 0 1 1 1 0 0 0]
 [1 0 1 1 0 1 1 0 0 0 1 0 1 0 0 0 1 0 1 1]
 [0 1 1 0 0 1 1 0 0 0 0 0 0 1 1 0 1 0 0 0]
 [1 1 0 0 1 0 0 1 0 0 1 0 1 1 0 0 0 0 1 1]
 [0 0 0 1 1 0 0 0 0 0 1 0 0 1 1 1 0 0 1 1]
 [0 0 0 1 1 1 0 1 0 0 0 1 0 1 0 0 0 0 0 0]
 [0 0 0 0 0 1 1 0 0 1 0 0 0 1 1 1 0 1 1 1]]