Maze shape: (10, 10)
Starting position: Point(x=1, y=8)
Exit: Point(x=6, y=1)
Maze:
[[0 1 0 0 0 0 1 0 0 0]
 [0 0 0 0 0 0 2 0 0 1]
 [0 1 0 1 0 0 1 0 1 1]
 [0 0 0 0 0 0 0 0 0 1]
 [0 0 1 1 0 1 0 0 0 0]
 [1 0 0 0 0 0 0 0 0 0]
 [0 0 0 0 1 0 0 0 0 0]
 [1 0 0 1 1 1 1 0 1 0]
 [0 0 0 0 1 0 0 0 0 0]
 [0 1 1 0 0 0 1 0 0 0]]