
Starting position: Point(x=18, y=2)
Exit: Point(x=3, y=18)
Maze:
[[1 1 0 1 1 0 1 0 0 0 1 1 1 0 0 0 0 0 1 0]
 [0 0 0 1 0 0 0 1 1 0 1 0 1 0 1 1 0 1 0 0]
 [0 1 0 0 0 1 0 0 1 0 1 0 0 0 0 0 0 0 0 0]
 [1 0 1 1 1 1 0 1 1 0 0 0 1 1 1 1 1 1 0 1]
 [1 1 0 0 0 0 0 1 1 0 1 0 1 0 0 0 0 0 0 0]
 [0 0 0 0 0 0 0 0 0 0 0 0 0 0 0 0 0 0 0 0]
 [0 1 1 1 1 1 0 1 0 1 1 0 0 0 1 0 1 1 1 0]
 [0 0 0 0 0 0 0 0 1 0 0 0 0 0 1 0 0 0 0 1]
 [0 1 1 0 0 1 0 0 0 1 1 0 1 0 1 1 0 1 0 0]
 [1 0 0 0 0 1 0 0 0 0 0 0 0 0 0 0 0 1 0 1]
 [0 1 0 0 0 1 0 1 0 1 0 0 1 1 0 0 1 0 0 0]
 [1 0 0 0 0 1 0 1 0 0 1 0 0 1 1 1 1 1 0 1]
 [0 0 1 0 0 1 0 1 0 1 0 1 0 0 0 0 0 1 0 1]
 [1 1 1 0 0 0 1 1 0 0 0 0 0 0 0 1 1 0 0 0]
 [0 0 0 0 1 0 0 0 0 0 0 0 0 1 0 1 0 0 0 0]
 [1 0 1 0 0 1 0 1 0 0 1 0 0 0 0 0 0 0 1 0]
 [1 0 1 0 1 0 0 1 1 0 0 1 0 0 0 1 0 0 0 1]
 [0 0 1 0 0 1 0 1 0 0 1 0 0 1 0 0 0 0 0 0]
 [0 0 0 2 0 1 0 1 1 0 0 1 0 0 0 0 0 1 0 0]
 [0 0 0 0 0 0 0 0 1 0 1 1 0 0 0 1 0 1 0 0]]