
Starting position: Point(x=1, y=1)
Exit: Point(x=14, y=16)
Maze:
[[0 0 1 1 0 0 0 0 0 0 1 0 0 0 0 0 0 0 0 0]
 [0 0 1 0 1 0 1 0 1 0 0 0 0 1 0 1 0 0 0 1]
 [0 0 0 0 0 0 0 0 1 1 1 0 0 0 0 0 0 0 0 1]
 [1 1 0 0 0 0 0 1 1 0 1 1 0 1 0 0 1 0 1 0]
 [0 1 1 0 0 0 0 0 1 0 1 0 1 0 0 0 0 1 1 0]
 [1 0 1 0 1 0 1 0 1 0 0 0 1 1 0 0 1 1 0 1]
 [1 0 0 0 0 0 0 0 0 0 0 0 0 0 1 0 1 0 0 0]
 [0 1 1 0 1 1 1 0 1 1 0 0 1 0 1 0 0 0 0 1]
 [1 0 0 0 0 0 0 0 0 0 0 0 0 0 1 0 0 0 0 1]
 [0 0 0 1 1 1 0 0 1 1 1 1 0 0 0 0 0 0 0 1]
 [1 0 0 0 0 0 1 0 1 0 1 1 1 1 0 0 0 1 0 0]
 [1 0 1 0 0 0 0 0 0 0 0 0 0 0 0 0 0 1 0 1]
 [1 0 1 0 1 0 0 1 1 1 0 1 1 1 0 1 0 1 0 1]
 [0 0 0 0 0 0 0 1 0 0 0 0 0 0 0 0 0 0 0 0]
 [1 1 1 0 1 1 0 0 0 1 0 0 0 0 0 1 1 0 0 0]
 [0 0 0 0 0 1 1 1 1 1 1 1 0 0 0 0 1 1 0 0]
 [0 1 0 1 0 0 0 0 0 0 0 1 0 1 2 0 0 0 0 0]
 [0 0 1 1 1 0 0 0 1 1 0 0 0 1 0 0 0 1 0 0]
 [1 0 0 0 0 0 1 0 0 0 0 1 0 1 1 0 1 0 0 0]
 [1 1 0 0 1 1 1 0 1 1 0 0 0 0 1 1 0 1 1 1]]