Starting position: Point(x=4, y=4)
Exit: Point(x=14, y=14)
Maze:
[[0 0 0 1 0 1 0 1 0 1 1 1 0 0 0 0 1 0 1 1]
 [1 0 1 0 0 1 1 0 0 0 1 0 1 0 1 0 1 1 0 1]
 [1 0 0 0 0 0 0 0 0 0 0 0 0 0 0 0 0 0 0 1]
 [0 1 1 1 1 1 1 0 1 0 0 0 1 1 0 1 1 1 0 0]
 [0 0 0 0 0 0 0 0 1 0 0 0 0 1 0 0 0 0 0 0]
 [1 0 1 0 1 1 1 0 0 0 1 0 0 0 0 0 1 1 0 1]
 [0 0 1 0 0 0 0 0 1 1 1 1 1 0 0 0 0 0 0 0]
 [0 0 0 0 0 1 1 0 0 0 0 1 0 0 0 0 1 1 0 0]
 [0 1 1 1 0 0 1 1 0 1 0 0 0 1 1 0 1 0 1 0]
 [0 1 0 0 0 0 0 1 0 0 1 0 0 0 1 0 0 0 0 1]
 [0 0 0 1 1 0 1 1 1 1 0 0 0 0 0 0 0 0 1 1]
 [0 0 1 1 0 0 0 0 0 1 0 0 0 1 1 0 0 0 0 0]
 [1 0 1 0 0 1 0 1 0 0 1 0 0 0 0 0 1 0 0 0]
 [0 0 1 0 1 1 0 1 0 0 0 0 0 0 0 1 1 0 0 1]
 [1 0 1 0 1 0 0 1 0 0 0 0 1 1 2 0 1 0 0 1]
 [0 0 1 0 1 1 0 1 1 1 0 0 1 0 0 1 1 1 1 1]
 [0 0 1 0 1 0 0 0 0 1 0 0 1 0 0 0 0 0 0 0]
 [0 0 1 0 1 0 0 0 0 1 1 1 1 1 1 0 0 0 0 0]
 [0 0 1 1 0 0 0 0 0 0 0 0 1 1 0 0 1 1 0 0]
 [0 1 0 1 0 0 0 0 1 1 0 1 0 1 0 0 1 0 1 0]]
Policy 0:
α=0.1, γ=0.99, ϵ=0.01
[[-487.79986951 -481.60321651 -483.04474009 -487.61914613]
 [   0.            0.            0.            0.        ]
 [   0.            0.            0.            0.        ]
 ...
 [   0.            0.            0.            0.        ]
 [   0.            0.            0.            0.        ]
 [   0.            0.            0.            0.        ]]

