
Starting position: Point(x=17, y=3)
Exit: Point(x=2, y=15)
Maze:
[[0 0 0 1 0 0 0 1 0 0 1 1 1 1 0 0 0 1 0 1]
 [0 0 1 0 0 0 0 0 0 0 0 0 0 1 0 1 0 0 0 1]
 [0 0 0 1 1 1 1 1 0 0 1 0 1 0 0 1 0 1 0 0]
 [0 0 0 0 0 0 0 1 1 0 1 0 1 0 0 0 0 0 0 1]
 [1 1 0 1 0 0 0 0 1 0 1 0 0 1 0 1 0 1 0 0]
 [0 1 0 1 0 1 0 0 0 0 0 0 1 1 1 0 0 1 0 1]
 [0 0 0 1 0 0 1 1 0 1 0 0 0 0 0 0 0 1 0 1]
 [1 1 0 1 0 1 0 0 1 0 0 0 0 1 0 1 0 1 0 0]
 [0 0 0 0 0 1 1 0 0 1 0 0 0 1 0 1 0 1 0 0]
 [0 1 0 0 0 1 1 0 0 0 0 0 0 1 0 0 0 0 0 0]
 [0 0 0 0 0 0 1 0 0 1 0 1 0 0 0 1 1 0 1 1]
 [0 1 1 1 1 0 0 0 1 1 0 0 1 0 0 1 0 1 1 1]
 [1 0 0 0 0 0 1 1 0 0 0 0 0 0 0 0 0 0 0 1]
 [0 1 1 1 1 0 0 0 0 0 1 0 1 0 1 0 1 0 1 0]
 [1 0 0 0 0 0 0 1 1 1 1 0 1 0 0 1 0 0 1 0]
 [1 1 2 1 0 1 1 0 0 0 0 0 0 0 0 0 0 0 1 0]
 [1 0 0 1 0 1 1 1 0 1 0 0 1 0 1 0 1 0 0 0]
 [0 0 0 1 0 0 0 0 0 1 0 0 1 0 0 0 1 0 1 1]
 [0 0 0 0 1 1 0 1 0 1 0 1 1 0 0 0 1 0 0 0]
 [0 0 0 0 0 0 0 1 0 0 0 0 1 0 0 1 1 1 0 1]]