
Starting position: Point(x=3, y=1)
Exit: Point(x=14, y=14)
Maze:
[[1 0 1 0 0 1 0 0 1 1 0 1 0 0 1 0 0 1 1 1]
 [0 0 0 0 0 1 0 0 0 0 0 0 0 0 0 0 1 0 0 1]
 [0 1 1 1 0 1 0 1 0 0 0 1 1 1 0 0 1 1 0 1]
 [1 0 0 0 0 0 0 0 0 0 0 0 0 0 0 1 1 0 0 0]
 [0 1 1 1 0 1 1 1 0 0 0 1 0 1 0 0 0 0 0 1]
 [1 0 0 0 0 0 0 0 0 0 0 0 0 0 0 1 0 1 0 0]
 [0 1 0 1 0 1 0 1 0 1 0 0 1 1 0 0 0 1 1 0]
 [1 0 0 0 0 0 0 1 1 0 0 0 0 1 0 0 0 0 0 1]
 [0 0 1 1 0 0 1 0 1 1 1 1 1 1 0 0 0 0 1 0]
 [1 0 0 0 0 0 0 0 0 1 0 0 0 0 0 1 0 0 0 0]
 [0 1 0 1 1 0 0 1 0 0 0 0 0 1 0 1 0 1 0 0]
 [1 1 0 0 0 0 0 0 0 1 1 0 1 1 0 1 0 1 0 1]
 [0 0 0 1 0 1 0 1 0 1 0 0 0 0 0 1 1 1 0 1]
 [0 1 1 1 0 0 0 0 1 1 0 1 0 0 0 0 0 1 0 0]
 [0 0 0 0 0 1 0 1 1 1 1 1 0 1 2 1 1 1 0 1]
 [0 0 1 0 1 0 1 0 0 0 0 0 0 1 0 0 0 1 0 0]
 [0 1 0 0 0 0 0 1 1 1 1 0 0 1 0 0 0 0 0 1]
 [1 0 0 0 0 1 0 1 1 1 0 0 0 0 0 0 1 0 0 0]
 [0 1 0 1 0 1 0 0 0 0 0 1 0 1 1 0 1 1 0 0]
 [1 0 1 0 0 0 1 0 0 0 0 0 1 0 0 1 0 1 1 1]]