
Starting position: Point(x=16, y=1)
Exit: Point(x=2, y=15)
Maze:
[[0 0 0 1 1 1 1 0 0 1 0 1 1 0 0 1 0 0 0 0]
 [0 0 0 0 1 0 0 1 0 1 1 0 1 1 0 0 0 0 0 1]
 [1 1 0 0 1 1 0 1 0 0 1 0 1 0 0 1 1 0 1 0]
 [0 0 0 1 1 0 0 0 0 0 1 0 1 0 1 1 1 0 1 1]
 [1 0 0 0 0 0 0 1 1 0 1 0 1 0 0 0 1 0 0 0]
 [0 1 0 1 0 0 0 0 1 1 0 0 0 0 0 0 0 0 1 0]
 [1 0 0 1 1 1 0 1 1 0 0 1 1 0 1 1 1 0 0 1]
 [0 0 0 1 0 1 0 0 0 0 0 1 0 1 1 1 1 1 0 0]
 [1 0 0 0 0 0 0 1 0 0 0 0 0 0 0 0 0 1 0 0]
 [0 0 1 0 1 0 0 1 0 1 1 0 1 0 0 0 1 0 0 1]
 [0 0 0 0 0 1 0 0 0 0 0 0 1 0 1 1 0 0 0 1]
 [1 0 1 1 1 1 0 1 1 1 1 0 0 0 0 1 0 0 0 0]
 [0 0 0 0 0 1 0 0 0 0 1 1 0 0 1 1 0 0 0 1]
 [1 0 1 1 1 1 0 0 0 0 0 1 1 0 1 1 0 1 1 1]
 [0 0 1 1 1 0 0 0 1 0 0 1 0 1 0 0 0 0 0 1]
 [0 0 2 0 1 1 0 0 1 0 0 0 0 0 0 0 0 0 0 1]
 [0 1 0 0 0 0 0 0 0 0 1 1 0 1 1 1 0 1 0 1]
 [0 1 0 0 1 1 1 0 0 0 0 1 0 0 0 1 0 0 0 0]
 [1 0 0 0 0 0 0 1 0 0 0 0 1 0 1 1 0 1 0 0]
 [0 0 0 0 1 1 0 0 0 1 0 1 0 1 1 0 0 0 0 1]]