
Starting position: Point(x=1, y=7)
Exit: Point(x=6, y=1)
Maze:
[[1 0 0 0 0 0 0 1 1 0]
 [1 0 0 0 1 0 2 1 0 0]
 [1 1 0 0 1 0 0 0 0 0]
 [1 0 1 0 1 1 0 0 0 1]
 [0 0 0 0 0 1 0 0 0 0]
 [0 1 0 1 0 0 1 0 0 0]
 [0 1 1 1 0 0 1 0 0 1]
 [0 0 0 0 1 0 0 0 0 1]
 [0 0 0 0 0 0 0 0 0 1]
 [1 0 0 1 1 1 0 1 1 0]]