
Starting position: Point(x=1, y=15)
Exit: Point(x=16, y=4)
Maze:
[[0 1 1 0 0 0 0 0 1 1 0 0 0 0 0 1 1 0 0 1]
 [0 0 0 0 1 0 1 1 0 1 0 1 0 1 0 1 0 0 0 0]
 [1 0 0 1 1 0 0 1 0 0 0 0 0 0 0 0 0 0 1 1]
 [1 0 0 0 1 0 1 1 0 0 0 0 0 0 0 0 0 0 0 1]
 [1 0 0 0 0 0 0 1 0 0 0 0 1 1 1 1 2 0 1 0]
 [0 0 1 0 1 0 1 1 0 0 0 0 0 0 1 1 0 1 1 1]
 [0 0 1 0 1 0 0 0 0 1 1 0 1 0 0 0 1 0 0 0]
 [0 0 0 0 1 0 1 0 0 0 0 0 1 0 1 0 0 0 0 0]
 [0 0 1 0 1 0 1 1 0 1 1 0 0 0 1 1 0 0 0 0]
 [1 0 1 0 0 0 1 0 0 0 1 0 0 0 0 1 1 1 1 0]
 [0 0 1 0 1 0 0 1 0 0 0 0 0 0 0 0 0 0 0 0]
 [0 0 0 0 1 1 1 0 0 0 0 0 1 0 1 0 1 0 1 1]
 [1 0 1 0 0 0 1 1 1 1 0 0 0 0 1 0 0 0 0 1]
 [1 0 1 1 0 1 1 1 1 0 0 1 1 1 0 1 0 0 0 0]
 [0 0 1 1 0 0 1 0 0 1 0 0 0 0 0 0 1 0 1 0]
 [1 0 0 1 0 0 1 0 0 0 0 1 0 0 0 0 1 0 0 0]
 [0 0 0 1 0 1 0 0 0 0 1 0 0 0 0 0 1 0 1 1]
 [1 1 1 1 0 0 0 0 1 0 0 0 0 1 0 1 1 0 0 1]
 [0 0 0 0 0 0 0 0 1 0 1 0 1 1 0 0 0 1 0 0]
 [1 0 1 0 0 0 1 0 0 0 0 0 0 1 1 0 1 0 1 1]]