
Starting position: Point(x=3, y=15)
Exit: Point(x=15, y=4)
Maze:
[[0 1 0 0 1 0 0 0 0 1 0 1 1 1 1 1 0 1 0 0]
 [0 0 0 0 0 1 1 0 1 0 1 0 1 0 0 0 0 0 0 0]
 [0 0 0 1 0 0 0 0 0 0 0 0 0 1 0 0 0 1 0 1]
 [0 1 0 1 1 0 0 0 1 0 0 0 0 0 0 1 0 1 0 0]
 [1 1 1 0 0 0 0 1 0 0 1 1 1 1 0 2 0 0 0 0]
 [0 0 0 0 0 0 0 1 1 0 0 1 1 1 0 0 0 1 0 0]
 [0 1 1 0 0 1 0 0 1 0 0 0 1 0 0 0 0 1 0 1]
 [1 0 0 0 0 0 0 0 1 0 0 1 1 0 1 1 0 0 0 1]
 [0 1 1 0 0 1 0 0 0 1 0 1 0 0 0 1 0 0 0 0]
 [1 0 1 1 1 1 0 0 0 0 0 0 0 1 1 0 0 0 0 0]
 [1 0 1 1 0 1 1 1 0 0 0 1 0 0 0 0 0 0 0 1]
 [0 0 1 0 0 0 1 0 0 1 0 0 0 1 0 1 0 0 0 0]
 [1 0 0 1 0 0 0 0 1 1 1 1 0 1 0 1 1 0 1 0]
 [0 0 0 0 0 0 1 0 1 0 1 0 0 0 1 0 1 1 0 0]
 [0 1 1 0 1 0 0 0 0 0 0 0 1 0 0 0 0 0 0 0]
 [0 1 1 0 1 1 0 0 0 0 1 0 1 1 1 1 1 0 0 1]
 [1 0 0 0 0 1 1 0 0 0 1 0 0 0 0 0 0 1 0 0]
 [1 0 1 0 0 1 0 0 0 0 0 0 1 1 0 1 0 0 0 1]
 [1 0 1 0 0 0 0 1 0 0 1 0 0 0 0 0 0 1 0 1]
 [0 1 0 1 0 1 1 0 1 0 1 1 0 1 0 1 0 0 0 0]]