
Starting position: Point(x=16, y=15)
Exit: Point(x=2, y=2)
Maze:
[[1 0 0 1 1 1 1 0 0 1 1 1 1 0 0 1 1 1 0 0]
 [0 0 0 1 1 0 1 0 0 1 0 1 0 1 1 0 1 0 0 0]
 [0 0 2 0 0 0 0 1 0 0 0 0 0 0 1 0 1 0 1 0]
 [1 0 1 0 0 0 1 1 0 0 1 0 0 1 1 0 1 0 0 0]
 [1 0 0 1 0 0 0 0 0 0 1 0 0 0 0 0 0 0 1 1]
 [0 0 0 0 0 0 0 0 1 1 0 0 0 0 1 1 1 0 1 0]
 [1 0 0 1 1 1 1 0 0 0 0 0 0 0 1 0 0 0 0 1]
 [0 0 0 0 0 0 0 0 1 0 1 0 1 0 1 1 0 1 1 0]
 [1 1 1 1 1 0 1 0 0 0 0 1 1 0 1 1 0 1 0 0]
 [1 0 0 0 0 0 0 0 1 0 0 0 0 0 0 1 0 1 0 1]
 [0 0 1 0 0 0 1 0 0 0 1 1 0 1 0 1 0 0 0 0]
 [1 0 1 0 0 0 1 1 1 1 0 0 1 1 0 1 0 1 1 0]
 [1 0 1 0 1 1 0 0 0 1 0 1 0 0 0 0 0 0 0 0]
 [0 0 0 0 1 0 0 1 0 1 0 0 1 0 0 1 0 0 1 1]
 [0 0 0 0 0 0 0 0 0 0 0 1 0 1 0 1 0 0 0 0]
 [0 1 1 0 1 0 0 0 0 0 0 0 0 0 0 0 0 0 1 1]
 [0 0 0 0 0 0 1 1 1 1 1 1 0 1 0 1 0 0 0 0]
 [1 1 1 1 1 1 1 0 0 0 1 0 1 1 0 1 0 0 0 0]
 [0 0 0 0 0 0 0 0 1 0 0 0 0 0 0 0 0 1 0 1]
 [0 1 0 1 0 0 1 1 0 0 0 1 1 1 1 0 0 0 0 1]]